R 1200 800
NO ./srcs/arcenciel.xpm
SO ./srcs/planche.xpm
WE ./srcs/metal.xpm
EA ./srcs/white.xpm
S  ./srcs/barrel.xpm
F 0,111,0
C 50,0,150

        1111111111111111111111111
        1000000000110000000000001
        1011000001110N00002000001
        1001000000000000000000001
111111111111000001110000000000001
100000000011111111111111111111111
11110111111111011100000010201
11110111111111111111111111111
11110111111111111111111111111
11110111111111011101010010201
11000000110101011100000000201
100020000000000011000000100011111111111111
10000000000000001101010010001
110000011101010111110111100111
11110111 1110101 101111010001
11111111 1111111 111111111101
                           1
	   